00002000000000000000000000
00000000500000000011100000
00000400400005000010100000
00000000020000520010100000
00004001110050000040000000
00000402520000055000000000
00000053030040000000000000
00005000000000000040000000
00000000000001101100020000
00054000001110000005400000
00000004001410005000050000
00000500001000000140000000
00022003000040000100020000
00000000500000040000000005
00101000004010455000002000
00101000000000044000030000
00111005005000000400011200
00000000000500500400001000