00000000000000000000000000
00110000500000000000400000
00000400400005000000000000
00002200000000050002100000
00004000410151000040000000
00000400510001055002003000
00000050111141002000300000
00005001000000000040000000
23000000000300011000002000
00054000001110000005400000
00000004001410005000050000
00000500002020000040000000
00000000000040000500000000
00303000500000040011100005
00101000004000455000000000
00101000003000004400020000
00111005005000000420503000
00000000000500500400004000