00002000000000000000000000
00000000500000000011100000
00000011111000010100201111
00000005120000520010100001
00004211110050112040000000
00032400520000055001000000
00010053040040001113000000
00015001130100000040000000
00003000051001101100010000
00054000001112000005400000
00011204001410015000050000
00001150001000000140010000
00022003000040000100320000
00000000500000040000100005
00101000004010425000002000
00101000000000044000010000
00005005000000400300020000
00000000000500500400001000