00000000000000000000000000
00000000000000000000000000
00000010000044000000000000
00000010000000000000000000
00000004400000004410000000
00000010000500000000000000
00000000005050000020000000
00000010050005000000000000
00020001005050000000300000
00000000001500000100010000
00000000001000000000000000
00000400001110000000000010
00000020000000500000000001
00000000004000000300000010
00000002000000000000000010
00000000010000500000000001
00020000021000100000000001
00000000000000000000000000