00002000000033000500000000
00000000500000000011100000
00400400400005000010100000
00000000050020520010100000
00030000011110011151000000
00040000020011110010100000
00000000010000200010100000
00005101000000000040000000
00001212100005003400020000
00054000003000020005400000
00000004001410005000050000
00000500001000000140000000
00022003000040000100020000
00000000500000040000000005
00000000011420300110002000
00204000010000044000030000
00004005015000000400011200
00000000000500500400001000